height 8
width 8
map
T..TTTTT
.T.TTTTT
.....TTT
TT.T.TTT
TT.....T
TTTT.T.T
TTTT....
TTTTTT.T